企业团体综合意外险	/product/tuanyixian.shtml
平安行·全球旅游保险（境外）	/product/quanqiulvyoubaoxian.shtml
团体短期综合意外险	/product/tuantiduanqiyiwaixian.shtml
一年期意外险	/product/yinianqizongheyiwaixian.shtml
平安个人意外伤害险	/product/gerenyiwaishanghaibaoxian.shtml
团体国内旅游保险	/product/tuantiguoneilvyoubaoxian.shtml
平安e生保	/product/eshengbao.shtml
短期综合意外险	/product/duanqiyiwaixian.shtml
团体境外旅游意外险	/product/tuantijingwailvyouyiwaixian.shtml
平安行·国内自助游保险	/product/guoneilvyoubaoxianzzy.shtml
团体交通意外险	/product/tuantijiaotongyiwai.shtml
雇主责任险	/product/guzhuzerenxian.shtml
乐享美食	/product/lexiangmeishi.shtml
平安萌宠保-爱心版	/product/mengchongbaoaixinban.shtml
乐享旅馆	/product/lexianglvguan.shtml
车主无忧	/pa18shopnst/era/web/product/microCarSafe/index.shtml
平安小微店家保	/pa18shopnst/page/mStoreFront_index.html
企业团体产品在线预约	/product/qiyecaichanbaoxianyuyue.shtml
家庭财产保险	/product/jiatingcaichanbaoxian.shtml
儿童综合医疗保险	/product/ertongzongheyiliaobaoxian.shtml
平安行·欧洲签证旅游保险	/product/ouzhouqianzhenglvyoubaoxianjingwai.shtml
中老年人综合医疗保险	/product/laonianrenzongheyiliaobaoxian.shtml
全球交通意外保险	/product/quanqiujiaotongyiwaibaoxian.shtml
平安行·自驾旅游保险	/product/guoneilvyoubaoxianzjy.shtml
平安行·高端内美澳非旅游保险	/product/gaoduanmeiaofeilvyoubaoxian.shtml
成人重大疾病保险	/product/chengrenzhongdajibingbaoxian.shtml
平安行·美国加拿大旅游保险	/product/meiguojianadalvyoubaoxian.shtml
平安行·境内节假日旅游保险	/product/yilujingneijiejiarilvyoubaoxian.shtml
职场综合医疗保险	/product/zhichangzongheyiliaobaoxian.shtml
平安行·境外留学保险	/product/jingwailiuxuexian.shtml
平安行·境外工作保险	/product/jingwaigongzuobaoxian.shtml
平安道路交通意外保险	/product/quanchewuyou.shtml
女性关爱保险	/product/nvxingguanaibaoxian.shtml
出租无忧家居保险	/product/chuzubaoxian.shtml
航空意外险	/product/hangyixian.shtml
儿童重大疾病保险	/product/ertongzhongdajibingbaoxian.shtml
驾驶人意外险	/product/jiashirenyiwaibaoxian.shtml
平安行·港澳旅游保险	/product/jingwailvyoubaoxiangat.shtml
平安行·高原旅游保险	/product/guoneilvyoubaoxiangyy.shtml
银行卡安全保险	/product/yinhangkaanquanbaoxian.shtml
平安手机碎屏险（苹果版）	/product/shoujisuipingxian.shtml
平安手机碎屏险(安卓版)	/product/shoujisuipingxiananzhuoban.shtml
平安行·宝岛台湾旅游险	/product/baodaotaiwan.shtml
少儿综合保险	/product/shaoerzonghexian.shtml
癌症医疗保险	/product/aizhengyiliaobaoxian.shtml
少儿健康医疗保险	/product/shaoerjiankangyiliaobaoxian.shtml
老年人综合保险	/product/laonianrenjiankangbaoxian.shtml
成人全面重疾保险	/product/chengrenquanmianzhongjibaoxian.shtml
家庭大病医疗保险	/product/jiatingdabingyiliaobaoxian.shtml
少儿重大疾病保险	/product/shaoerzhongji.shtml
旅行健康保险	/product/lvxingjiankangxian.shtml
家庭综合保险	/product/jiatingzonghebaoxian.shtml
住院医疗保险	/product/zhuyuanyiliaobaoxian.shtml
家庭出行综合保险	/product/jiashirenyiwaixian.shtml
平安学生综合保险	/product/xueshengzonghebaoxian.shtml
一年期重大疾病保险	/product/yinianqizhongjibaoxian.shtml
家庭保(共用保额)	/product/pinganjiatingbaobaoxian.shtml
重大疾病保险（含轻重疾）	/product/zhechanjiankangbaozhan.shtml
家庭健康保险	/product/jiatingjiankangbaoxian.shtml